LLLLLLLL
LLLWWWLL
LLLLLWWL
LLLWLLLL
LWWWLLLL
LLWLLLLO
LLLLLLLL
LLLLWWWW
LLLLWLLL
LLLLWLLL
