LLLLLLLLLL
LLLWWWLLLL
LLLLLWWLLL
LLLWLLLLLL
LWWWLLLLLL
LLWLLLLOLL
LLLLLLLLLL
LLLLWWWWWW
LLLLWLLLLL
LLLLWLLLLL
LLLLWLLLLL
LLLLLLLLLL
